+-+-+-+-+-+-+-+-+-+-+-+-+-+-+-+-+
|         |               |     |
+ + + + + + + +-+ + + + + + + + +
|             |                 |
+-+ + + + + + + + + + + + + + + +
|                               |
+ + + + + + + + + +-+ + + + + + +
|     |           |             |
+ + +-+-+ + + + + + + + + + + +-+
|     |         |               |
+ + + + + + + +-+ + + + + + + + +
| |                         |   |
+ +-+ + + + + + + + + +-+ +-+ + +
|                       |       |
+ + + + + + + +-+-+ + + + + + + +
|             |   |             |
+ + + + + +-+ + + + + + +-+ + +-+
|           | |   |       |     |
+ + + + + + + +-+-+ + + + + + + +
|     |                         |
+ + + +-+ + +-+ + + + + + + + + +
|           |                   |
+ + + + + + + + + + + + + + + + +
|                               |
+-+ + + + + + + + +-+ + + +-+ + +
|         |       |         |   |
+ + + + + +-+ + + + + + + + + + +
|                               |
+ + + + + + + + + + + + + + + + +
|                       |       |
+ + + + + + + + + + + +-+ + + + +
|     |         |           |   |
+-+-+-+-+-+-+-+-+-+-+-+-+-+-+-+-+
