+-+-+-+-+-+-+-+-+-+-+-+-+-+-+-+-+
|       |               |       |
+ + + + + + + + + + + + + +-+ + +
|                         |     |
+ + + + + + + + + + + + + + + + +
|           |       |           |
+ + + + + +-+ + + +-+ + + + + + +
|                               |
+ + +-+ + + + + + + + + + + + +-+
|     |                         |
+-+ + + + + + + + + + + + + + + +
|             |             |   |
+ +-+ + + + + +-+ + + +-+ + +-+ +
| |                     |       |
+ + + + + + + +-+-+ + + + + + + +
|             |   |             |
+ + + + + + + + + + + + + + + + +
|             |   |             |
+ + + + + + + +-+-+ + + +-+ + + +
|       |                 |     |
+ + + + +-+ +-+ + + + + + + + +-+
|           |                   |
+-+ + + + + + + + + + + + + + + +
|                               |
+ + + + + + + +-+ +-+ + + + + + +
|               | |             |
+ +-+ + + + + + + + + + + + + + +
|   |                       |   |
+ + + + + + + + + + + + + + +-+ +
|       |               |       |
+ + + +-+ + + + + + + +-+ + + + +
|         |                 |   |
+-+-+-+-+-+-+-+-+-+-+-+-+-+-+-+-+
